*************X******
E *                *
* * ** ** *TTTTT T**
*    ***  T      T *
* *****  TT  TTTT* *
*     *TTT  TTTT*  *
***** *  TT TTT** **
*      * *T  T*    *
* **** * *** *   * *
*  **  *  *    * * *
* * * ***** * *  * *
* * *  *  *  ** ****
* *  *  * ***   ** *
*    *  *          *
********************